25 20 5
********************
**   *  ** *  *** **
*  ********  *   ***
**    * * *** **   *
** ***  *   *  **  *
*  ***  * **    *  *
**   *             *
* ** **       *    *
*     ** **   *  * *
*      ** *    * * *
** *       *   * * *
* ***      * ***  **
*   *       ** *   *
* **       *       *
*      ** *   *   **
*  *          **** *
** ***   **     ** *
*     *      *   * *
*   * *   *  * *** *
* *              * *
**        *   ** * *
*           ***    *
***  * ** * ****   *
**  * *  **  *     *
********************

